What is your name?

>sit table
You glance over at the counter before sitting down. You notice that the barista is kind of cute. As you're staring, they look up and you catch their eye, and they smile. Your face flushes.
You sit down.

Conversation Start!

* * *

What is your name?

>Amanda
Hi, Amanda!

The Cafe
An Interactive Fiction by Amanda Hua and Lane Bohrer
Release 1 / Serial number 210123 / Inform 7 build 6M62 (I6/v6.33 lib 6/12N) SD

Cafe
A barista stands humming behind the counter. Above the worker are three wooden panels showing the menu. There is an all gender bathroom next to the counter. To go to the bathroom, say "go inside".

There is a table near the window. Plenty of sunlight, a decent amount of surface area for a laptop and papers, or to put your head down if you're tired.

There is a booth in the back of the room, its seats facing the table near the window. It is currently occupied by a teenager and a small child.

You can also see Sage and a counter (in which are pastries, sandwiches, tea and iced coffee) here.

>sit table
You glance over at the counter before sitting down. You notice that the barista with the name tag "Sage" is kind of cute. As you're staring, they look up and you catch their eye, and they smile. Your face flushes.
You sit down.

The people in the booth behind you stand up to leave. You wish they had done that before you sat down, but now it would look weird if you rushed over to the booth, so you decide to stay where you are. The cute barista you were staring at takes off their apron and walks over to the booth with a drink. Looks like they're on break. Something compels you go talk to them. Maybe the color of their eyes? You stand up and walk over to the booth. "Mind if I sit with you?" They look up and smile. Your heart flips in anticipation. "Sure! I'm not going anywhere."

>take laptop
You can't see any such thing.

>open backpack
You feel like maybe you should talk to Sage. I guess you really only have one option.

"You new around here? I don't think I've seen you before." You shrug. "Just got to Seattle yesterday, been looking around since then."

>talk sage
You can't see any such thing.

>talk Sage
You can't see any such thing.

>talk to Sage
You can't see any such thing.

>talk to Sage
You can't see any such thing.

* * *

>talk to Sage
You can't see any such thing.

>sit table
You glance over at the counter before sitting down. You notice that the barista with the name tag "Sage" is kind of cute. As you're staring, they look up and you catch their eye, and they smile. Your face flushes.
You sit down.

"You new around here? I don't think I've seen you before." You shrug. "Just got to Seattle yesterday, been looking around since then."

>sit table
You glance over at the counter before sitting down. You notice that the barista with the name tag "Sage" is kind of cute. As you're staring, they look up and you catch their eye, and they smile. Your face flushes.
You sit down.

After a moment of silence, Sage says, "I like your septum piercing!" You feel your face grow hot. "Thanks," you say, but nothing else comes to mind.

>tell sage
You can't see any such thing.

>tell Sage
You can't see any such thing.

>look
You feel like maybe you should talk to Sage. I guess you really only have one option.

"What brings you to Seeds?" Her eyes are really pretty. You give a start. Stop staring! "I am actually here to check out UW. I got into the CS Masters program, but I also have a job offer in New York, so I thought it would be a good idea to check out the locations for myself."

>help
That's not a verb I recognise.

>tell Sage about weather
You can't see any such thing.

* * *

>talk to Sage
You can't see any such thing.

>talk to Sage about weather
"Is the weather always like this here?" you ask. "It seems like the only downside."

Sage laughs. "It's not too bad, just takes some getting used to."

* * *

>talk to sage
"Hi, my name is Amanda. I was wondering if I could join you?"

* * *

>tell sage about weather
"Is the weather always like this here?" you ask. "It seems like the only downside."

Sage laughs. "It's not too bad, just takes some getting used to."

>tell sage about location
"Are you from Seattle originally?" you ask.

"Nope, I used to live in St. Louis, but I moved to Seattle for school and have been here since I graduated, last spring." Note to self: they're around your age.

>look
You feel like maybe you should talk to Sage. You did sit down with them, after all.

"You new around here? I don't think I've seen you before." You shrug. "Just got to Seattle yesterday, been looking around since then."

>tell sage about day
You feel like maybe you should talk to Sage. You did sit down with them, after all.

After a moment of silence, Sage says, "I like your septum piercing!" You feel your face grow hot. "Thanks," you say, but nothing else comes to mind.

* * *

>talk to sage about weather
You can't see any such thing.

* * *

>sit table
You glance over at the counter before sitting down. You notice that the barista with the name tag "Sage" is kind of cute. As you're staring, they look up and you catch their eye, and they smile. Your face flushes.
You sit down.

The people in the booth behind you stand up to leave. You wish they had done that before you sat down, but now it would look weird if you rushed over to the booth, so you decide to stay where you are. The cute barista you were staring at takes off their apron and walks over to the booth with a drink. Looks like they're on break. Something compels you go talk to them. Maybe the color of their eyes? You stand up and walk over to the booth. "Mind if I sit with you?" They look up and smile. Your heart flips in anticipation. "Sure! I'm not going anywhere."

"You new around here? I don't think I've seen you before." You shrug. "Just got to Seattle yesterday, been looking around since then."

>talk to Sage
"Hi, my name is Amanda. I was wondering if I could join you?"

After a moment of silence, Sage says, "I like your septum piercing!" You feel your face grow hot. "Thanks," you say, but nothing else comes to mind.

>talk to Sage about weather
You can't see any such thing.

>talk to Sage about location
You can't see any such thing.

>talk to Sage
"Hi, my name is Amanda. I was wondering if I could join you?"

"What brings you to Seeds?" Her eyes are really pretty. You give a start. Stop staring! "I am actually here to check out UW. I got into the CS Masters program, but I also have a job offer in New York, so I thought it would be a good idea to check out the locations for myself."

* * *

>buy pastries
You go up to the counter and buy a pastry. The barista with a nametag that says "Sage" smiles at you. You notice their grin is kinda cute.

>buy pastries
You already bought food!
You go up to the counter and buy a pastry. The barista with a nametag that says "Sage" smiles at you. You notice their grin is kinda cute.

* * *

>buy pastries
You go up to the counter and buy a pastry. The barista with a nametag that says "Sage" smiles at you. You notice their grin is kinda cute.

>sit table
You sit down.

The people in the booth behind you stand up to leave. You wish they had done that before you sat down, but now it would look weird if you rushed over to the booth, so you decide to stay where you are. The cute barista you were staring at takes off their apron and walks over to the booth with a drink. Looks like they're on break. Something compels you go talk to them. Maybe the color of their eyes? You stand up and walk over to the booth. "Mind if I sit with you?" They look up and smile. Your heart flips in anticipation. "Sure! I'm not going anywhere."

"You new around here? I don't think I've seen you before." You shrug. "Just got to Seattle yesterday, been looking around since then."

>look
You feel like maybe you should talk to Sage. You did sit down with them, after all. Here are some topics that come to mind: gay, weather, job, cafe...

After a moment of silence, Sage says, "I like your septum piercing!" You feel your face grow hot. "Thanks," you say, but nothing else comes to mind.

>talk to sage about weather
"Is the weather always like this here?" you ask. "It seems like the only downside."

Sage laughs. "It's not too bad, just takes some getting used to."

>talk to sage about weather
You feel like maybe you should talk to Sage. You did sit down with them, after all. Here are some topics that come to mind: gay, weather, job, cafe...

"What brings you to Seeds?" Her eyes are really pretty. You give a start. Stop staring! "I am actually here to check out UW. I got into the CS Masters program, but I also have a job offer in New York, so I thought it would be a good idea to check out the locations for myself."

"Oh shoot, I gotta go, I have an interview and I lost track of time!" She looks at you and grins. Your heart skips again. "Well, it was lovely to meet you! I'm sure we'll meet again. Good luck with your decision!" Before you can say anything else, they run out the door.

>look
Cafe
A barista stands humming behind the counter. Above the worker are three wooden panels showing the menu. There is an all gender bathroom next to the counter. To go to the bathroom, say "go inside".

There is a table near the window. Plenty of sunlight, a decent amount of surface area for a laptop and papers, or to put your head down if you're tired.

There is a booth in the back of the room, its seats facing the table near the window. It is currently occupied by a teenager and a small child.

You can also see Sage and a counter (in which are sandwiches, tea and iced coffee) here.

* * *

What is your name?

>Amanda H
It's okay, we're on a first name basis. What's just your first name?

What is your name?

>Amanda
Hi, Amanda!

The Cafe
An Interactive Fiction by Amanda Hua and Lane Bohrer
Release 1 / Serial number 210123 / Inform 7 build 6M62 (I6/v6.33 lib 6/12N) SD

Cafe
A barista stands humming behind the counter. Above the worker are three wooden panels showing the menu. There is an all gender bathroom next to the counter. To go to the bathroom, say "go inside".

There is a table near the window. Plenty of sunlight, a decent amount of surface area for a laptop and papers, or to put your head down if you're tired.

There is a booth in the back of the room, its seats facing the table near the window. It is currently occupied by a teenager and a small child.

You can also see a counter (in which are pastries, sandwiches, tea and iced coffee) here.

* * *

What is your name?

>amanda
Hi, amanda!

The Cafe
An Interactive Fiction by Amanda Hua and Lane Bohrer
Release 1 / Serial number 210123 / Inform 7 build 6M62 (I6/v6.33 lib 6/12N) SD

Cafe
A barista stands humming behind the counter. Above the worker are three wooden panels showing the menu. There is an all gender bathroom next to the counter. To go to the bathroom, say "go inside".

There is a table near the window. Plenty of sunlight, a decent amount of surface area for a laptop and papers, or to put your head down if you're tired.

There is a booth in the back of the room, its seats facing the table near the window. It is currently occupied by a teenager and a small child.

You can also see a counter (in which are pastries, sandwiches, tea and iced coffee) here.

>sit table
You glance over at the counter before sitting down. You notice that the barista with the name tag "Sage" is kind of cute. As you're staring, they look up and you catch their eye, and they smile. Your face flushes.
You sit down.

The people in the booth behind you stand up to leave. You wish they had done that before you sat down, but now it would look weird if you rushed over to the booth, so you decide to stay where you are. The cute barista you were staring at takes off their apron and walks over to the booth with a drink. Looks like they're on break. The way you see it, you have two options: talk to Sage, or continue staring at your screen with no progress.

>open bag
You can't see any such thing.

>open backpack
You feel like maybe you should talk to Sage. I guess you really only have one option.

>talk to sage
You can't see any such thing.

>talk to Sage
You can't see any such thing.

* * *

What is your name?

>am
Hi, am!

The Cafe
An Interactive Fiction by Amanda Hua and Lane Bohrer
Release 1 / Serial number 210123 / Inform 7 build 6M62 (I6/v6.33 lib 6/12N) SD

Cafe
A barista stands humming behind the counter. Above the worker are three wooden panels showing the menu. There is an all gender bathroom next to the counter. To go to the bathroom, say "go inside".

There is a table near the window. Plenty of sunlight, a decent amount of surface area for a laptop and papers, or to put your head down if you're tired.

There is a booth in the back of the room, its seats facing the table near the window. It is currently occupied by a teenager and a small child.

You can also see a counter (in which are pastries, sandwiches, tea and iced coffee) here.

>sit table
You glance over at the counter before sitting down. You notice that the barista with the name tag "Sage" is kind of cute. As you're staring, they look up and you catch their eye, and they smile. Your face flushes.
You sit down.

The people in the booth behind you stand up to leave. You wish they had done that before you sat down, but now it would look weird if you rushed over to the booth, so you decide to stay where you are. The cute barista you were staring at takes off their apron and walks over to the booth with a drink. Looks like they're on break. The way you see it, you have two options: talk to Sage, or continue staring at your screen with no progress.

>talk Sage
You can't see any such thing.

* * *

What is your name?

>a
Hi, a!

The Cafe
An Interactive Fiction by Amanda Hua and Lane Bohrer
Release 1 / Serial number 210123 / Inform 7 build 6M62 (I6/v6.33 lib 6/12N) SD

Cafe
A barista stands humming behind the counter. Above the worker are three wooden panels showing the menu. There is an all gender bathroom next to the counter. To go to the bathroom, say "go inside".

There is a table near the window. Plenty of sunlight, a decent amount of surface area for a laptop and papers, or to put your head down if you're tired.

There is a booth in the back of the room, its seats facing the table near the window. It is currently occupied by a teenager and a small child.

You can also see a counter (in which are pastries, sandwiches, tea and iced coffee) here.

>sit table
You glance over at the counter before sitting down. You notice that the barista with the name tag "Sage" is kind of cute. As you're staring, they look up and you catch their eye, and they smile. Your face flushes.
You sit down.

The people in the booth behind you stand up to leave. You wish they had done that before you sat down, but now it would look weird if you rushed over to the booth, so you decide to stay where you are. The cute barista you were staring at takes off their apron and walks over to the booth with a drink. Looks like they're on break. The way you see it, you have two options: talk to Sage, or continue staring at your screen with no progress.

* * *

>talk Sage
You can't see any such thing.

>talk table
"Hi, my name is a. I was wondering if I could join you?"

* * *

What is your name?

>lane
Hi, lane!

The Cafe
An Interactive Fiction by Amanda Hua and Lane Bohrer
Release 1 / Serial number 210123 / Inform 7 build 6M62 (I6/v6.33 lib 6/12N) SD

Cafe
A barista stands humming behind the counter. Above the worker are three wooden panels showing the menu. There is an all gender bathroom next to the counter. To go to the bathroom, say "go inside".

There is a table near the window. Plenty of sunlight, a decent amount of surface area for a laptop and papers, or to put your head down if you're tired.

There is a booth in the back of the room, its seats facing the table near the window. It is currently occupied by a teenager and a small child.

You can also see Sage and a counter (in which are pastries, sandwiches, tea and iced coffee) here.

>sit at table
You glance over at the counter before sitting down. You notice that the barista with the name tag "Sage" is kind of cute. As you're staring, they look up and you catch their eye, and they smile. Your face flushes.
You sit down.

The people in the booth behind you stand up to leave. You wish they had done that before you sat down, but now it would look weird if you rushed over to the booth, so you decide to stay where you are. The cute barista you were staring at takes off their apron and walks over to the booth with a drink. Looks like they're on break. Something compels you go talk to them. Maybe the color of their eyes? You stand up and walk over to the booth. "Mind if I sit with you?" They look up and smile. Your heart flips in anticipation. "Sure! I'm not going anywhere."

>talk to sage
You can't see any such thing.

>talk sage
I didn't understand that sentence.

>say hello
(to Sage)
You feel like maybe you should talk to Sage. You did sit down with them, after all. Here are some topics that come to mind: gay, weather, job, cafe...

"You new around here? I don't think I've seen you before." You shrug. "Just got to Seattle yesterday, been looking around since then."

>weather's funny
That's not a verb I recognise.

>weather
That's not a verb I recognise.

>say weather
(to Sage)
You feel like maybe you should talk to Sage. You did sit down with them, after all. Here are some topics that come to mind: gay, weather, job, cafe...

After a moment of silence, Sage says, "I like your septum piercing!" You feel your face grow hot. "Thanks," you say, but nothing else comes to mind.

>talk about jobs
You can't see any such thing.

>cafe
That's not a verb I recognise.

>say cafe
(to Sage)
You feel like maybe you should talk to Sage. You did sit down with them, after all. Here are some topics that come to mind: gay, weather, job, cafe...

"What brings you to Seeds?" Her eyes are really pretty. You give a start. Stop staring! "I am actually here to check out UW. I got into the CS Masters program, but I also have a job offer in New York, so I thought it would be a good idea to check out the locations for myself."

>tell Sage job
I didn't understand that sentence.

>tell job to Sage
You can't see any such thing.

* * *

What is your name?

>Lane
Hi, Lane!

The Cafe
An Interactive Fiction by Amanda Hua and Lane Bohrer
Release 1 / Serial number 210123 / Inform 7 build 6M62 (I6/v6.33 lib 6/12N) SD

Cafe
A barista stands humming behind the counter. Above the worker are three wooden panels showing the menu. There is an all gender bathroom next to the counter. To go to the bathroom, say "go inside".

There is a table near the window. Plenty of sunlight, a decent amount of surface area for a laptop and papers, or to put your head down if you're tired.

There is a booth in the back of the room, its seats facing the table near the window. It is currently occupied by a teenager and a small child.

You can also see Sage and a counter (in which are pastries, sandwiches, tea and iced coffee) here.

>buy tea
You go up to the counter and buy a drink. The barista with a nametag that says "Sage" smiles at you. You notice their grin is kinda cute.

>sit down at table
You sit down.

The people in the booth behind you stand up to leave. You wish they had done that before you sat down, but now it would look weird if you rushed over to the booth, so you decide to stay where you are. The cute barista you were staring at takes off their apron and walks over to the booth with a drink. Looks like they're on break. Something compels you go talk to them. Maybe the color of their eyes? You stand up and walk over to the booth. "Mind if I sit with you?" They look up and smile. Your heart flips in anticipation. "Sure! I'm not going anywhere."

"You new around here? I don't think I've seen you before." You shrug. "Just got to Seattle yesterday, been looking around since then."

>tell Sage hi
I didn't understand that sentence.

>tell sage about day
You feel like maybe you should talk to Sage. You did sit down with them, after all. Here are some topics that come to mind: gay, weather, job, cafe...

After a moment of silence, Sage says, "I like your septum piercing!" You feel your face grow hot. "Thanks," you say, but nothing else comes to mind.

>ask sage about location
"Are you from Seattle originally?" you ask.

"Nope, I used to live in St. Louis, but I moved to Seattle for school and have been here since I graduated, last spring." Note to self: they're around your age.

>talk to sage about cafe
You feel like maybe you should talk to Sage. You did sit down with them, after all. Here are some topics that come to mind: gay, weather, job, cafe...

"If you're not used to it, the Seattle weather can be a bit dreary," Sage remarks.

"Oh shoot, I gotta go, I have an interview and I lost track of time!" She looks at you and grins. Your heart skips again. "Well, it was lovely to meet you! I'm sure we'll meet again. Good luck with your decision!" Before you can say anything else, they run out the door.

* * *

>buy tea
You go up to the counter and buy a drink. The barista with a nametag that says "Sage" smiles at you. You notice their grin is kinda cute.

>sit at table
You sit down.

The people in the booth behind you stand up to leave. You wish they had done that before you sat down, but now it would look weird if you rushed over to the booth, so you decide to stay where you are. The cute barista you were staring at takes off their apron and walks over to the booth with a drink. Looks like they're on break. Something compels you go talk to them. Maybe the color of their eyes? You stand up and walk over to the booth. "Mind if I sit with you?" They look up and smile. Your heart flips in anticipation. "Sure! I'm not going anywhere."

"You new around here? I don't think I've seen you before." You shrug. "Just got to Seattle yesterday, been looking around since then."

>ask Sage about seattle
You feel like maybe you should talk to Sage. You did sit down with them, after all. I could talk about: being gay, weather, job, the cafe...

After a moment of silence, Sage says, "I like your septum piercing!" You feel your face grow hot. "Thanks," you say, but nothing else comes to mind.

* * *

>ask about Seattle
You can't see any such thing.

>ask Sage about Seattle
"Are you from Seattle originally?" you ask.

"Nope, I used to live in St. Louis, but I moved to Seattle for school and have been here since I graduated, last spring." Note to self: they're around your age.

* * *

>sit at table
You glance over at the counter before sitting down. You notice that the barista with the name tag "Sage" is kind of cute. As you're staring, they look up and you catch their eye, and they smile. Your face flushes.
You sit down.

The people in the booth behind you stand up to leave. You wish they had done that before you sat down, but now it would look weird if you rushed over to the booth, so you decide to stay where you are. The cute barista you were staring at takes off their apron and walks over to the booth with a drink. Looks like they're on break. Something compels you go talk to them. Maybe the color of their eyes? You stand up and walk over to the booth. "Mind if I sit with you?" They look up and smile. Your heart flips in anticipation. "Sure! I'm not going anywhere."

>ask Sage about job
You feel like maybe you should talk to Sage. You did sit down with them, after all. I could talk about: being gay, weather, job, the cafe...

"You new around here? I don't think I've seen you before." You shrug. "Just got to Seattle yesterday, been looking around since then."

>talk to Sage about gay
"So," you say. "This might be a bit forward, but what are your pronouns? And are you gay?" The last part slips out before you can stop yourself. You flush. "I, er," they say. "I use she/they pronouns, thanks for asking!" They smile at you. "And yes, I listen to Girl in Red. What gave it away? Was it the giant dangly earrings?" You laugh. "No, just the bangs and blue hair."

>tell Sage about weather
"Is the weather always like this here?" you ask. "It seems like the only downside."

Sage laughs. "It's not too bad, just takes some getting used to."

>ask Sage about location
"Are you from Seattle originally?" you ask.

"Nope, I used to live in St. Louis, but I moved to Seattle for school and have been here since I graduated, last spring." Note to self: they're around your age.

"Oh shoot, I gotta go, I have an interview and I lost track of time!" She looks at you and grins. Your heart skips again. "Well, it was lovely to meet you! I'm sure we'll meet again. Good luck with your decision!" Before you can say anything else, they run out the door.

It's a new day, full of possibility. Maybe I should go to the cafe and see if Sage is there. Or I could explore somewhere new.

>somewhere new
I tried out a new place. It was fine, but nothing special. Maybe I'll go back to Seeds tomorrow.

It's a new day, full of possibility. Maybe I should go to the cafe and see if Sage is there. Or I could explore somewhere new.

>cafe
I walked by, but Sage wasn't working. I hope I didn't miss my only chance.

It's a new day, full of possibility. Maybe I should go to the cafe and see if Sage is there. Or I could explore somewhere new.

>explore
I tried out a new place. It was fine, but nothing special. Maybe I'll go back to Seeds tomorrow.

It's a new day, full of possibility. Maybe I should go to the cafe and see if Sage is there. Or I could explore somewhere new.

>sage
That's not a verb I recognise.

>go to the cafe
You can't see any such thing.

>go to cafe
I've got a good feeling about today.

* * *

>buy sandwich
You go up to the counter and buy a sandwich. The barista with a nametag that says "Sage" smiles at you. You notice their grin is kinda cute.

>buy sandwiches
You already bought food! This is gonna look a bit weird.
You go up to the counter and buy a sandwich. The barista with a nametag that says "Sage" smiles at you. You notice their grin is kinda cute.

>sit down at booth
There are people there! You can't sit on them.

>sit at table
You sit down.

The people in the booth behind you stand up to leave. You wish they had done that before you sat down, but now it would look weird if you rushed over to the booth, so you decide to stay where you are. The cute barista you were staring at takes off their apron and walks over to the booth with a drink. Looks like they're on break. Something compels you go talk to them. Maybe the color of their eyes? You stand up and walk over to the booth. "Mind if I sit with you?" They look up and smile. Your heart flips in anticipation. "Sure! I'm not going anywhere."

"You new around here? I don't think I've seen you before." You shrug. "Just got to Seattle yesterday, been looking around since then."

>talk to Sage about seattle
"Are you from Seattle originally?" you ask.

"Nope, I used to live in St. Louis, but I moved to Seattle for school and have been here since I graduated, last spring." Note to self: they're around your age.

>ask Sage about school
You feel like maybe you should talk to Sage. You did sit down with them, after all. I could talk about: being gay, weather, job, the cafe...

After a moment of silence, Sage says, "I like your septum piercing!" You feel your face grow hot. "Thanks," you say, but nothing else comes to mind.

>talk to Sage about the cafe
You feel like maybe you should talk to Sage. You did sit down with them, after all. I could talk about: being gay, weather, job, the cafe...

"If you're not used to it, the Seattle weather can be a bit dreary," Sage remarks.

"Oh shoot, I gotta go, I have an interview and I lost track of time!" She looks at you and grins. Your heart skips again. "Well, it was lovely to meet you! I'm sure we'll meet again. Good luck with your decision!" Before you can say anything else, they run out the door.

>get up
But you aren't in anything at the moment.

It's a new day, full of possibility. Maybe I should go to the cafe and see if Sage is there. Or I could explore somewhere new.

>explore
I tried out a new place. It was fine, but nothing special. Maybe I'll go back to Seeds tomorrow.

It's a new day, full of possibility. Maybe I should go to the cafe and see if Sage is there. Or I could explore somewhere new.

>cafe
I walked by, but Sage wasn't working. I hope I didn't miss my only chance.

It's a new day, full of possibility. Maybe I should go to the cafe and see if Sage is there. Or I could explore somewhere new.

>cafe
I've got a good feeling about today.

Cafe
A barista stands humming behind the counter. Above the worker are three wooden panels showing the menu. There is an all gender bathroom next to the counter. To go to the bathroom, say "go inside".

There is a table near the window. Plenty of sunlight, a decent amount of surface area for a laptop and papers, or to put your head down if you're tired.

There is a booth in the back of the room, its seats facing the table near the window. It is currently occupied by a teenager and a small child.

You can also see Sage and a counter (in which are pastries, tea and iced coffee) here.